HW|  |  |  |  |IM|  |  |  |  |HW|
  |  |  |  |  |IM|  |  |  |  |  |
  |  |  |  |  |IM|  |  |  |  |  |
  |  |  |  |  |IM|  |  |  |  |  |
  |  |  |  |DM|  |DM|  |  |  |  |
IM|IM|IM|IM|  |DM|  |IM|IM|IM|IM|
  |  |  |  |DM|  |DM|  |  |  |  |
  |  |  |  |  |IM|  |  |  |  |  |
  |  |  |  |  |IM|  |  |  |  |  |
  |  |  |  |  |IM|  |  |  |  |  |
  |  |  |  |  |IM|  |  |  |  |  |
HW|  |  |  |  |IM|  |  |  |  |HW|