DM|  |  |  |  |  |  |  |  |  |  |DM
DM|  |  |  |  |  |  |  |  |  |  |  
DM|  |  |  |  |  |  |  |  |  |  |  
DM|  |  |  |  |  |  |IM|  |  |IM|  
DM|IM|IM|IM|IM|IM|  |  |  |  |  |  
  |  |  |IM|  |  |  |  |  |  |  |  
  |  |  |  |  |  |  |  |  |  |  |DM
  |  |  |  |  |  |  |  |IM|  |  |  
  |  |  |  |  |  |  |IM|  |  |  |  
  |  |HW|  |  |  |IM|  |  |  |  |  
  |  |  |  |  |  |  |  |HW|  |  |  
HW|  |  |  |  |  |  |  |  |  |  |  